A# ## ###### ####
 #   #  #  #    #
 # ### ##  # ## #
 #   #     # B# #
 ##### ####### ##
     # #   #    #
#### # # # # ####
   # #   #      #
#### ##### ######