########
#A     #
#####  #
#   ## #
# #### #
#    B #
########