# #    #   ##B#         # # #
# # ##             #### # # #
### ##             #### # # #
### ################ ## # # #
###             ##    # # # #
###### ########## ####### # # #
###### ####             #   #
A      ######################